"Country","Continent","Year","X0_19","X20_44","X45_64","X65_100","Total"
"United Republic of Tanzania","AFRICA",2020,34531088,20238280,6053164,1952087,62774619
"United Republic of Tanzania","AFRICA",2040,53479852,38203420,13159009,4217237,109059518
"United Republic of Tanzania","AFRICA",2060,72264626,61608479,26121097,10049032,170043234
"United Republic of Tanzania","AFRICA",2080,87017630,85451364,44109099,22046406,238624499
"United Republic of Tanzania","AFRICA",2100,95453642,104722296,63287595,40368282,303831815
"Uganda","AFRICA",2020,27413580,15063905,3692227,1017991,47187703
"Uganda","AFRICA",2040,42376880,29806337,9054439,2367305,83604961
"Uganda","AFRICA",2060,54656743,48475181,19731130,6369556,129232610
"Uganda","AFRICA",2080,61516768,64683917,34225668,15354276,175780629
"Uganda","AFRICA",2100,62557003,74445158,47614848,29141205,213758214
"Sudan","AFRICA",2020,22082685,14751888,5100683,1605947,43541203
"Sudan","AFRICA",2040,29646014,25033381,9433669,3244400,67357464
"Sudan","AFRICA",2060,35535020,34602661,17253243,6225515,93616439
"Sudan","AFRICA",2080,39510112,42619125,24685587,11874502,118689326
"Sudan","AFRICA",2100,40587139,48129154,31508435,18423345,138648073
"South Africa","AFRICA",2020,21823082,23673751,9856043,3368353,58721229
"South Africa","AFRICA",2040,21523360,26185174,15462769,5905087,69076390
"South Africa","AFRICA",2060,20112276,26720150,18246431,10288000,75366857
"South Africa","AFRICA",2080,18339618,25182573,19802572,14268659,77593422
"South Africa","AFRICA",2100,16773826,23086497,19244814,17382561,76487698
"Nigeria","AFRICA",2020,111518467,67038922,21945338,5649974,206152701
"Nigeria","AFRICA",2040,162302704,118471167,41265059,11133162,333172092
"Nigeria","AFRICA",2060,207403459,184244262,77691478,23304159,492643358
"Nigeria","AFRICA",2080,235343753,244395779,127877246,49066883,656683661
"Nigeria","AFRICA",2100,243569903,283257246,177181477,89933690,793942316
"Niger","AFRICA",2020,14631030,6619017,2204615,620031,24074693
"Niger","AFRICA",2040,28544591,15855787,4073118,1281424,49754920
"Niger","AFRICA",2060,45624179,32131758,10292068,2607170,90655175
"Niger","AFRICA",2080,59469187,53019186,21850372,7114755,141453500
"Niger","AFRICA",2100,67076308,70924927,37790155,16395170,192186560
"Mozambique","AFRICA",2020,17776527,10415322,3087125,1030221,32309195
"Mozambique","AFRICA",2040,26606165,19538660,6364579,1933709,54443113
"Mozambique","AFRICA",2060,33990752,30491191,13098941,4431364,82012248
"Mozambique","AFRICA",2080,38531299,40319073,21577849,10239103,110667324
"Mozambique","AFRICA",2100,40005700,46616721,29760530,18663399,135046350
"Morocco","AFRICA",2020,12889039,13946451,7411420,2823808,37070718
"Morocco","AFRICA",2040,11975766,14816885,10663619,6257435,43713705
"Morocco","AFRICA",2060,10797669,14295965,11307119,10309036,46709789
"Morocco","AFRICA",2080,9396805,12872182,11292691,12663858,46225536
"Morocco","AFRICA",2100,8345576,11356627,10244472,13893477,43840152
"Malawi","AFRICA",2020,11000992,6986535,1708360,587804,20283691
"Malawi","AFRICA",2040,15610238,12566128,4488125,1172216,33836707
"Malawi","AFRICA",2060,18988648,18443416,8882004,3485170,49799238
"Malawi","AFRICA",2080,20605068,22969620,13636683,7548594,64759965
"Malawi","AFRICA",2100,20353519,25352125,17467723,12537235,75710602
"Madagascar","AFRICA",2020,14102993,9585752,3143769,858284,27690798
"Madagascar","AFRICA",2040,19814087,16281269,6258572,2013728,44367656
"Madagascar","AFRICA",2060,24323216,23374503,11404770,4492187,63594676
"Madagascar","AFRICA",2080,27021189,29302093,17065248,9063655,82452185
"Madagascar","AFRICA",2100,27574345,33130121,22058972,15238146,98001584
"Kenya","AFRICA",2020,26796165,19574516,5588720,1532296,53491697
"Kenya","AFRICA",2040,33574071,30709537,13045025,3958232,81286865
"Kenya","AFRICA",2060,37079031,39770575,21926826,10062146,108838578
"Kenya","AFRICA",2080,36977209,45011006,29415209,18804863,130208287
"Kenya","AFRICA",2100,34552565,45601605,34248780,27720949,142123899
"Ghana","AFRICA",2020,14744640,11054636,3891815,1042664,30733755
"Ghana","AFRICA",2040,18174262,16572509,7230672,2244381,44221824
"Ghana","AFRICA",2060,20799290,21291755,11340321,4465563,57896929
"Ghana","AFRICA",2080,21599406,24808093,15187390,7661311,69256200
"Ghana","AFRICA",2100,20947196,26195149,18276437,11335823,76754605
"Ethiopia","AFRICA",2020,56823175,40087425,11794893,4053577,112759070
"Ethiopia","AFRICA",2040,66350254,65970540,25688969,8129630,166139393
"Ethiopia","AFRICA",2060,66172512,79569856,46920108,19616116,212278592
"Ethiopia","AFRICA",2080,60930634,81249808,59299983,39231945,240712370
"Ethiopia","AFRICA",2100,55056744,75901644,62422948,56148583,249529919
"Egypt","AFRICA",2020,42997519,37991048,16467345,5485572,102941484
"Egypt","AFRICA",2040,48425631,48935166,28622262,11082454,137065513
"Egypt","AFRICA",2060,51310996,58340406,35938793,21415050,167005245
"Egypt","AFRICA",2080,49380049,62601566,44396394,31231550,187609559
"Egypt","AFRICA",2100,45543243,60743045,49352904,43108864,198748056
"Democratic Republic of the Congo","AFRICA",2020,50455635,27543368,8804332,2701866,89505201
"Democratic Republic of the Congo","AFRICA",2040,78838578,55016525,17621237,5637660,157114000
"Democratic Republic of the Congo","AFRICA",2060,99377263,90570572,36818154,12382839,239148828
"Democratic Republic of the Congo","AFRICA",2080,107630850,118364661,64351031,28361704,318708246
"Democratic Republic of the Congo","AFRICA",2100,105374298,131042116,88053215,54505615,378975244
"Cote d'Ivoire","AFRICA",2020,13797074,8792847,2804964,776865,26171750
"Cote d'Ivoire","AFRICA",2040,20173216,14965014,5235984,1421810,41796024
"Cote d'Ivoire","AFRICA",2060,26450072,22768768,9593049,2938783,61750672
"Cote d'Ivoire","AFRICA",2080,31610273,30707941,15364210,5731196,83413620
"Cote d'Ivoire","AFRICA",2100,34664783,37496639,21505553,9896377,103563352
"Cameroon","AFRICA",2020,13666550,8926993,2544849,819792,25958184
"Cameroon","AFRICA",2040,18682160,15104620,5628742,1605317,41020839
"Cameroon","AFRICA",2060,23014746,21732213,10277478,3940384,58964821
"Cameroon","AFRICA",2080,25728554,27432423,15614434,8100040,76875451
"Cameroon","AFRICA",2100,26489233,31192627,20388551,13570126,91640537
"Burkina Faso","AFRICA",2020,11581742,6829202,1988446,503955,20903345
"Burkina Faso","AFRICA",2040,16957045,12604950,4257597,1134205,34953797
"Burkina Faso","AFRICA",2060,21347978,19396371,8402661,2630991,51778001
"Burkina Faso","AFRICA",2080,23906655,25225291,13604149,5696786,68432881
"Burkina Faso","AFRICA",2100,24336026,28797747,18409881,10179213,81722867
"Angola","AFRICA",2020,18676690,10227332,3078528,844851,32827401
"Angola","AFRICA",2040,30284164,20420692,6563037,1981109,59249002
"Angola","AFRICA",2060,42102508,34407401,13603599,4482573,94596081
"Angola","AFRICA",2080,51618203,49168120,23853784,9913127,134553234
"Angola","AFRICA",2100,57441055,61476513,35392409,18550964,172860941
"Algeria","AFRICA",2020,15772426,16921423,7668176,2971230,43333255
"Algeria","AFRICA",2040,14890865,18447785,13287588,6622759,53248997
"Algeria","AFRICA",2060,15089004,18974917,13683298,12569007,60316226
"Algeria","AFRICA",2080,13515027,18560860,14986950,15360014,62422851
"Algeria","AFRICA",2100,12727206,16927771,14819970,18081525,62556472
"Yemen","ASIA",2020,14971143,11442514,2924211,907437,30245305
"Yemen","ASIA",2040,16778212,16977818,7521221,1709083,42986334
"Yemen","ASIA",2060,15711707,20020582,11725338,4692761,52150388
"Yemen","ASIA",2080,13333977,19246435,14632515,7873181,55086108
"Yemen","ASIA",2100,11551052,16590313,14601079,10793214,53535658
"Viet Nam","ASIA",2020,29149000,39173553,22115093,7922499,98360145
"Viet Nam","ASIA",2040,26987431,34942685,30404135,18894861,111229112
"Viet Nam","ASIA",2060,25632853,33548964,26278922,30267252,115727991
"Viet Nam","ASIA",2080,23260121,31180123,26385177,31465149,112290570
"Viet Nam","ASIA",2100,21997496,28860203,24454557,32333449,107645705
"Uzbekistan","ASIA",2020,11812945,13671295,6077349,1674236,33235825
"Uzbekistan","ASIA",2040,10905359,14282779,10062257,3996070,39246465
"Uzbekistan","ASIA",2060,9928066,13736602,10436834,7396493,41497995
"Uzbekistan","ASIA",2080,8741954,12372421,10494362,8833689,40442426
"Uzbekistan","ASIA",2100,7771989,10900533,9696098,9773611,38142231
"Turkey","ASIA",2020,26774489,31925381,17738619,7397261,83835750
"Turkey","ASIA",2040,23089756,31571100,23381809,14938153,92980818
"Turkey","ASIA",2060,20285143,28266363,24474813,23194691,96221010
"Turkey","ASIA",2080,17845934,24897899,22306717,27450031,92500581
"Turkey","ASIA",2100,15951563,22011065,19815275,27998399,85776302
"Thailand","ASIA",2020,15739552,24123703,20618606,8929007,69410868
"Thailand","ASIA",2040,12368367,20304490,18064199,17601418,68338474
"Thailand","ASIA",2060,10658658,15777693,16180879,18769660,61386890
"Thailand","ASIA",2080,9609333,13684710,12473858,18106101,53874002
"Thailand","ASIA",2100,8678486,12211272,10953883,15692048,47535689
"Saudi Arabia","ASIA",2020,10660316,15590090,7155776,1303458,34709640
"Saudi Arabia","ASIA",2040,10638139,15479255,11661036,4999181,42777611
"Saudi Arabia","ASIA",2060,10014510,15119700,11557928,9492423,46184561
"Saudi Arabia","ASIA",2080,8929904,13650319,11970220,11148192,45698635
"Saudi Arabia","ASIA",2100,8404146,12205531,10775796,12643226,44028699
"Republic of Korea","ASIA",2020,9330679,17675290,16418308,8082698,51506975
"Republic of Korea","ASIA",2040,8883517,12969571,14233225,16323095,52409408
"Republic of Korea","ASIA",2060,7751193,11661544,10590796,17717438,47720971
"Republic of Korea","ASIA",2080,7409249,10190471,9603545,15091178,42294443
"Republic of Korea","ASIA",2100,6977243,9704565,8203559,13821767,38707134
"Philippines","ASIA",2020,44363540,41274611,18391844,5673401,109703396
"Philippines","ASIA",2040,48175348,51987122,27723587,11561632,139447689
"Philippines","ASIA",2060,47211897,57449797,36686289,19374662,160722645
"Philippines","ASIA",2080,43491216,57303193,42143287,28540318,171478014
"Philippines","ASIA",2100,39315122,53523386,43329816,36891485,173059809
"Pakistan","ASIA",2020,90899385,78560820,29425553,9476576,208362334
"Pakistan","ASIA",2040,99425861,105328605,54032549,18707575,277494590
"Pakistan","ASIA",2060,98984648,119623507,74305266,35945159,328858580
"Pakistan","ASIA",2080,90317914,120529839,88039527,52962610,351849890
"Pakistan","ASIA",2100,80606348,111386343,91639550,68310690,351942931
"Nepal","ASIA",2020,12009610,11684806,4677690,1888138,30260244
"Nepal","ASIA",2040,9827730,14069804,7872568,3298339,35068441
"Nepal","ASIA",2060,7701603,11498445,10779170,6342228,36321446
"Nepal","ASIA",2080,6232401,9034616,9010922,9698316,33976255
"Nepal","ASIA",2100,5221826,7387084,7089179,9619813,29317902
"Myanmar","ASIA",2020,18993776,21174085,11115389,3525026,54808276
"Myanmar","ASIA",2040,17280547,22823316,14678950,6706274,61489087
"Myanmar","ASIA",2060,15065453,20910884,16792212,9308757,62077306
"Myanmar","ASIA",2080,13546814,18601467,15586915,11305464,59040660
"Myanmar","ASIA",2100,12242802,16774949,14101473,11623411,54742635
"Malaysia","ASIA",2020,10394158,13983103,6193763,2298299,32869323
"Malaysia","ASIA",2040,10328135,13788694,10634240,4917193,39668262
"Malaysia","ASIA",2060,9444490,13573183,10733193,9443619,43194485
"Malaysia","ASIA",2080,8702059,12289629,10947123,11368889,43307700
"Malaysia","ASIA",2100,8225276,11397725,9791775,12384587,41799363
"Japan","ASIA",2020,21797119,35036419,33975144,35686965,126495647
"Japan","ASIA",2040,19050079,28288234,28417443,39456311,115212067
"Japan","ASIA",2060,17628666,24773797,22827157,37517557,102747177
"Japan","ASIA",2080,16314273,22753154,19964638,32068578,91100643
"Japan","ASIA",2100,15189263,20923105,18421370,29998650,84532388
"Iraq","ASIA",2020,20760066,14532328,4817196,1393295,41502885
"Iraq","ASIA",2040,29648790,23955481,9882451,3265262,66751984
"Iraq","ASIA",2060,37929973,35053872,16776627,7102313,96862785
"Iraq","ASIA",2080,43677472,45559540,25475429,13264242,127976683
"Iraq","ASIA",2100,45813582,53278626,34178182,22285611,155556001
"Iran (Islamic Republic of)","ASIA",2020,24937327,37309821,16108554,5231427,83587129
"Iran (Islamic Republic of)","ASIA",2040,18538977,29564686,30616592,13179208,91899463
"Iran (Islamic Republic of)","ASIA",2060,17272274,24052226,22680966,27796996,91802462
"Iran (Islamic Republic of)","ASIA",2080,14682280,21287713,19050226,26586041,81606260
"Iran (Islamic Republic of)","ASIA",2100,13052104,18096705,17200344,24113143,72462296
"Indonesia","ASIA",2020,95335275,104676392,56517164,15694156,272222987
"Indonesia","ASIA",2040,89453354,113256393,74634803,34789638,312134188
"Indonesia","ASIA",2060,81695326,109008516,82947143,51055174,324706159
"Indonesia","ASIA",2080,73606512,100298671,81806070,64069995,319781248
"Indonesia","ASIA",2100,66538934,90780813,76913313,71792472,306025532
"India","ASIA",2020,493625373,542829689,256133727,90608964,1383197753
"India","ASIA",2040,455702019,596408371,383414270,169830914,1605355574
"India","ASIA",2060,397000455,559338763,442731495,279497398,1678568111
"India","ASIA",2080,347102116,493393307,426787902,359643677,1626927002
"India","ASIA",2100,307061641,434309179,382919531,392307029,1516597380
"China","ASIA",2020,327288076,506924652,416704638,173630900,1424548266
"China","ASIA",2040,270267779,399950022,409343612,337911401,1417472814
"China","ASIA",2060,241917427,343896764,309561965,393330401,1288706557
"China","ASIA",2080,212212350,301060997,272749394,349731476,1135754217
"China","ASIA",2100,191742155,264911569,240249835,323761657,1020665216
"Bangladesh","ASIA",2020,61769706,69468751,29703989,8832863,169775309
"Bangladesh","ASIA",2040,52071488,73270212,48899780,22052832,196294312
"Bangladesh","ASIA",2060,42762404,62693882,54615567,42669061,202740914
"Bangladesh","ASIA",2080,36397354,51570900,47942353,56737954,192648561
"Bangladesh","ASIA",2100,31879874,44121240,39631345,57916206,173548665
"Afghanistan","ASIA",2020,20274888,13025759,3732199,1022095,38054941
"Afghanistan","ASIA",2040,22062751,22443123,8176751,2231497,54914122
"Afghanistan","ASIA",2060,20419158,25797081,15810881,5280183,67307303
"Afghanistan","ASIA",2080,17663704,24675384,19057580,10927767,72324435
"Afghanistan","ASIA",2100,15237004,21627504,18886645,14658476,70409629
"Venezuela (Bolivarian Republic of)","AMERICA",2020,11697817,12556734,6519811,2398030,33172392
"Venezuela (Bolivarian Republic of)","AMERICA",2040,11186888,14017439,9179975,5194460,39578762
"Venezuela (Bolivarian Republic of)","AMERICA",2060,10098824,13801843,10587177,8325064,42812908
"Venezuela (Bolivarian Republic of)","AMERICA",2080,9054194,12596912,10746721,10864991,43262818
"Venezuela (Bolivarian Republic of)","AMERICA",2100,8186021,11342982,9943836,12169307,41642146
"United States of America","AMERICA",2020,82894017,110520464,82937511,55079542,331431534
"United States of America","AMERICA",2040,88750991,116413908,88057140,80846713,374068752
"United States of America","AMERICA",2060,91977332,122516567,94417462,95650864,404562225
"United States of America","AMERICA",2080,94799697,124732828,99391029,112040891,430964445
"United States of America","AMERICA",2100,96026798,126137301,100582301,124736756,447483156
"Peru","AMERICA",2020,11637766,12808806,6292355,2573251,33312178
"Peru","AMERICA",2040,10954604,13906243,9411427,5333814,39606088
"Peru","AMERICA",2060,9811205,13496557,10500885,8963432,42772079
"Peru","AMERICA",2080,8662825,12159641,10535407,11437009,42794882
"Peru","AMERICA",2100,7754133,10796828,9616682,12615807,40783450
"Paraguay","AMERICA",2020,2669857,2813219,1092388,490866,7066330
"Paraguay","AMERICA",2040,2593856,3122958,1890062,853423,8460299
"Paraguay","AMERICA",2060,2315659,3072358,2221222,1551639,9160878
"Paraguay","AMERICA",2080,2021588,2770708,2288919,2026155,9107370
"Paraguay","AMERICA",2100,1764649,2449593,2111523,2291450,8617215
"Nicaragua","AMERICA",2020,2361368,2612332,1046433,396435,6416568
"Nicaragua","AMERICA",2040,2018417,2747788,1869933,912426,7548564
"Nicaragua","AMERICA",2060,1698425,2432499,2080430,1810543,8021897
"Nicaragua","AMERICA",2080,1446573,2054168,1899427,2356471,7756639
"Nicaragua","AMERICA",2100,1261604,1761177,1621157,2404886,7048824
"Mexico","AMERICA",2020,45707238,52244624,25822493,10095672,133870027
"Mexico","AMERICA",2040,40563226,55928001,38327322,22871116,157689665
"Mexico","AMERICA",2060,35184100,50564401,43039799,38393907,167182207
"Mexico","AMERICA",2080,30996105,43864856,39923225,48313483,163097669
"Mexico","AMERICA",2100,27894623,38753689,34836648,50006084,151491044
"Honduras","AMERICA",2020,3905129,3930030,1390096,494010,9719265
"Honduras","AMERICA",2040,3705495,4721078,2745629,1167215,12339417
"Honduras","AMERICA",2060,3261100,4566345,3566688,2461879,13856012
"Honduras","AMERICA",2080,2893343,4087673,3547702,3587225,14115943
"Honduras","AMERICA",2100,2593673,3641322,3221931,3980301,13437227
"Haiti","AMERICA",2020,4756882,4443788,1592236,578279,11371185
"Haiti","AMERICA",2040,4516206,5084080,2843095,1010704,13454085
"Haiti","AMERICA",2060,3957750,4980655,3442145,1899788,14280338
"Haiti","AMERICA",2080,3376793,4478786,3515993,2481587,13853159
"Haiti","AMERICA",2100,2900504,3902441,3256754,2780603,12840302
"Guatemala","AMERICA",2020,7917064,6900109,2191293,902346,17910812
"Guatemala","AMERICA",2040,8327030,9351669,4705141,1880632,24264472
"Guatemala","AMERICA",2060,7878566,10093526,6928383,4315359,29215834
"Guatemala","AMERICA",2080,7182217,9749897,7763407,7142149,31837670
"Guatemala","AMERICA",2100,6497207,8977543,7652388,8893252,32020390
"El Salvador","AMERICA",2020,2303201,2470747,1133994,571124,6479066
"El Salvador","AMERICA",2040,1923877,2503877,1587684,946082,6961520
"El Salvador","AMERICA",2060,1503802,2117069,1794282,1490880,6906033
"El Salvador","AMERICA",2080,1186771,1656249,1588544,1895354,6326918
"El Salvador","AMERICA",2100,968017,1330337,1251491,1854220,5404065
"Ecuador","AMERICA",2020,6287078,6529315,3161779,1357470,17335642
"Ecuador","AMERICA",2040,6258908,7584242,4754180,2864410,21461740
"Ecuador","AMERICA",2060,5756644,7734353,5752590,4798253,24041840
"Ecuador","AMERICA",2080,5183097,7199501,6043729,6450467,24876794
"Ecuador","AMERICA",2100,4689545,6513715,5707976,7409344,24320580
"Dominican Republic","AMERICA",2020,4148762,4101993,2016277,841326,11108358
"Dominican Republic","AMERICA",2040,3779043,4571362,2821368,1658958,12830731
"Dominican Republic","AMERICA",2060,3201437,4319471,3306289,2595327,13422524
"Dominican Republic","AMERICA",2080,2705543,3726232,3255745,3400529,13088049
"Dominican Republic","AMERICA",2100,2324016,3188411,2870381,3731052,12113860
"Cuba","AMERICA",2020,2425584,3583354,3637569,1848985,11495492
"Cuba","AMERICA",2040,2120901,2993846,2752956,3398371,11266074
"Cuba","AMERICA",2060,1878861,2622278,2313104,3373457,10187700
"Cuba","AMERICA",2080,1654030,2299951,2066756,2964059,8984796
"Cuba","AMERICA",2100,1496464,2048159,1810080,2764795,8119498
"Costa Rica","AMERICA",2020,1414956,1961378,1141715,526130,5044179
"Costa Rica","AMERICA",2040,1234604,1818401,1520071,1085821,5658897
"Costa Rica","AMERICA",2060,1098542,1585749,1447616,1633507,5765414
"Costa Rica","AMERICA",2080,992504,1401693,1276078,1805493,5475768
"Costa Rica","AMERICA",2100,911057,1264914,1129001,1722721,5027693
"Colombia","AMERICA",2020,15221229,19524989,11116721,4357473,50220412
"Colombia","AMERICA",2040,12651130,18339113,14424068,9200789,54615100
"Colombia","AMERICA",2060,10826791,15496270,14039609,13402785,53765455
"Colombia","AMERICA",2080,9479865,13315107,12066754,14920925,49782651
"Colombia","AMERICA",2100,8462516,11718126,10463724,14182037,44826403
"Chile","AMERICA",2020,4899384,6782971,4531802,2258482,18472639
"Chile","AMERICA",2040,4455369,6395185,5311409,4216641,20378604
"Chile","AMERICA",2060,4057583,5800179,5112913,5726399,20697074
"Chile","AMERICA",2080,3743877,5259753,4677629,6257487,19938746
"Chile","AMERICA",2100,3487827,4833170,4243220,6192597,18756814
"Canada","AMERICA",2020,8051916,12512862,10147912,6890515,37603205
"Canada","AMERICA",2040,8697191,12755384,10806384,10745726,43004685
"Canada","AMERICA",2060,9506610,13520648,10912515,12689306,46629079
"Canada","AMERICA",2080,9930814,13935094,11520814,14210506,49597228
"Canada","AMERICA",2100,10177758,14018459,11673240,15752536,51621993
"Brazil","AMERICA",2020,60549359,85102165,47791857,20419665,213863046
"Brazil","AMERICA",2040,50496719,76401841,63517472,41185624,231601656
"Brazil","AMERICA",2060,43336612,63943718,59521782,62491282,229293394
"Brazil","AMERICA",2080,38330328,54715525,50636014,68081199,211763066
"Brazil","AMERICA",2100,34655006,48405820,43533346,63828880,190423052
"Bolivia (Plurinational State of)","AMERICA",2020,4639218,4350136,1734475,820153,11543982
"Bolivia (Plurinational State of)","AMERICA",2040,4834587,5399966,2980942,1427848,14643343
"Bolivia (Plurinational State of)","AMERICA",2060,4594132,5775969,3936888,2587703,16894692
"Bolivia (Plurinational State of)","AMERICA",2080,4185848,5615976,4364475,3781027,17947326
"Bolivia (Plurinational State of)","AMERICA",2100,3771024,5184781,4353965,4636534,17946304
"Argentina","AMERICA",2020,14635648,16557255,9027162,5290334,45510399
"Argentina","AMERICA",2040,14425815,17884051,12438717,7837060,52585643
"Argentina","AMERICA",2060,13624608,18000294,13682831,11834708,57142441
"Argentina","AMERICA",2080,12629703,17098236,14085751,14747088,58560778
"Argentina","AMERICA",2100,11680905,15893354,13542179,16631040,57747478
"United Kingdom","EUROPE",2020,15697802,21542498,17317341,12776567,67334208
"United Kingdom","EUROPE",2040,15939286,21669514,17762503,17753930,73125233
"United Kingdom","EUROPE",2060,16555088,22255064,17623864,20537422,76971438
"United Kingdom","EUROPE",2080,16389177,22364262,18305711,22301548,79360698
"United Kingdom","EUROPE",2100,16190149,21839351,18326986,24619005,80975491
"Ukraine","EUROPE",2020,8985914,15215932,11826290,7551098,43579234
"Ukraine","EUROPE",2040,7571794,10792733,11801319,8492167,38658013
"Ukraine","EUROPE",2060,7153262,9604289,7928324,9504610,34190485
"Ukraine","EUROPE",2080,6284125,8798633,7397482,7807700,30287940
"Ukraine","EUROPE",2100,5769916,7826525,6904324,7684798,28185563
"Switzerland","EUROPE",2020,1724677,2829935,2458630,1657293,8670535
"Switzerland","EUROPE",2040,1830339,2713087,2451353,2592159,9586938
"Switzerland","EUROPE",2060,1927048,2842802,2307611,2986044,10063505
"Switzerland","EUROPE",2080,1941413,2824554,2439562,3096703,10302232
"Switzerland","EUROPE",2100,1944444,2766388,2371535,3400049,10482416
"Sweden","EUROPE",2020,2340176,3207025,2518179,2056306,10121686
"Sweden","EUROPE",2040,2507807,3256034,2720930,2673121,11157892
"Sweden","EUROPE",2060,2692262,3539366,2657578,3177191,12066397
"Sweden","EUROPE",2080,2745753,3649428,2933435,3473540,12802156
"Sweden","EUROPE",2100,2806079,3674018,2986257,3949193,13415547
"Spain","EUROPE",2020,8923704,13884578,14174557,9476380,46459219
"Spain","EUROPE",2040,7331364,11817243,11708143,14681752,45538502
"Spain","EUROPE",2060,7264383,10205627,9892716,14909491,42272217
"Spain","EUROPE",2080,6812015,9860891,8419979,13055980,38148865
"Spain","EUROPE",2100,6458927,9061757,8232086,12625472,36378242
"Serbia","EUROPE",2020,1923820,2901484,2244641,1633997,8703942
"Serbia","EUROPE",2040,1631131,2310504,2190711,1780478,7912824
"Serbia","EUROPE",2060,1388094,1941671,1749103,1928039,7006907
"Serbia","EUROPE",2080,1199220,1654157,1494746,1796249,6144372
"Serbia","EUROPE",2100,1056019,1445017,1281821,1681427,5464284
"Russian Federation","EUROPE",2020,33197715,50146752,38221505,22220870,143786842
"Russian Federation","EUROPE",2040,29588163,39902578,39258674,27087086,135836501
"Russian Federation","EUROPE",2060,30725663,39017445,28969311,30983525,129695944
"Russian Federation","EUROPE",2080,28388198,38612170,30098058,27576933,124675359
"Russian Federation","EUROPE",2100,27533983,36083563,30411144,29983915,124012605
"Romania","EUROPE",2020,3965651,6351297,5362473,3708941,19388362
"Romania","EUROPE",2040,3322772,4863337,4879502,4397499,17463110
"Romania","EUROPE",2060,2932683,4107681,3735448,4531351,15307163
"Romania","EUROPE",2080,2601089,3626616,3184533,3977554,13389792
"Romania","EUROPE",2100,2328449,3220227,2852384,3681348,12082408
"Portugal","EUROPE",2020,1848680,3068373,2981885,2319475,10218413
"Portugal","EUROPE",2040,1461767,2498977,2477764,3056661,9495169
"Portugal","EUROPE",2060,1318285,1981549,2086995,2997520,8384349
"Portugal","EUROPE",2080,1239862,1792136,1610594,2673855,7316447
"Portugal","EUROPE",2100,1140927,1633342,1480080,2349564,6603913
"Poland","EUROPE",2020,7400316,13521194,9981000,7039721,37942231
"Poland","EUROPE",2040,5624679,9208305,10833310,8988285,34654579
"Poland","EUROPE",2060,4957525,7160907,7194948,10667517,29980897
"Poland","EUROPE",2080,4253935,6156562,5648026,8741026,24799549
"Poland","EUROPE",2100,3798262,5293919,4911583,7238127,21241891
"Netherlands","EUROPE",2020,3752839,5199914,4795535,3432960,17181248
"Netherlands","EUROPE",2040,3654298,4998323,4172069,4875596,17700286
"Netherlands","EUROPE",2060,3457435,4807814,4086814,4910503,17262566
"Netherlands","EUROPE",2080,3342760,4543561,3930213,5094797,16911331
"Netherlands","EUROPE",2100,3209514,4358600,3689632,5221833,16479579
"Italy","EUROPE",2020,10636795,16247371,18086118,14161789,59132073
"Italy","EUROPE",2040,9654950,14582484,13532380,19102360,56872174
"Italy","EUROPE",2060,9420487,13342854,12302324,17619917,52685582
"Italy","EUROPE",2080,9192108,12878400,11063415,16191114,49325037
"Italy","EUROPE",2100,8795588,12247147,10714831,16061758,47819324
"Hungary","EUROPE",2020,1852928,3221474,2608259,1938593,9621254
"Hungary","EUROPE",2040,1614901,2429949,2539449,2173547,8757846
"Hungary","EUROPE",2060,1448009,2123263,1914396,2338641,7824309
"Hungary","EUROPE",2080,1319164,1889256,1697902,2062295,6968617
"Hungary","EUROPE",2100,1214111,1714645,1512928,1946369,6388053
"Greece","EUROPE",2020,2077526,3422819,3256985,2345242,11102572
"Greece","EUROPE",2040,1633238,2749844,2822671,3246116,10451869
"Greece","EUROPE",2060,1520068,2195571,2301195,3312461,9329295
"Greece","EUROPE",2080,1418694,2034590,1786188,2914180,8153652
"Greece","EUROPE",2100,1311120,1847228,1688045,2576424,7422817
"Germany","EUROPE",2020,14650152,24948805,24655404,18286089,82540450
"Germany","EUROPE",2040,14473333,21371684,20893024,24361516,81099557
"Germany","EUROPE",2060,13889887,20713630,17949990,24365343,76918850
"Germany","EUROPE",2080,13430866,19349971,17591924,23208556,73581317
"Germany","EUROPE",2100,13045830,18461677,16100230,23425546,71033283
"France","EUROPE",2020,15621433,19630528,16851160,13618044,65721165
"France","EUROPE",2040,15473488,20333450,15571038,18270335,69648311
"France","EUROPE",2060,15522384,20227547,16346621,19130893,71227445
"France","EUROPE",2080,15534284,20225013,16187674,20900921,72847892
"France","EUROPE",2100,15260061,19966048,16301786,22713764,74241659
"Czechia","EUROPE",2020,2148346,3479063,2853813,2152202,10633424
"Czechia","EUROPE",2040,1914695,2742512,2948189,2659451,10264847
"Czechia","EUROPE",2060,1952882,2596854,2191462,3036229,9777427
"Czechia","EUROPE",2080,1829543,2546096,2113924,2625421,9114984
"Czechia","EUROPE",2100,1774775,2382911,2078081,2656398,8892165
"Belgium","EUROPE",2020,2645305,3641657,3101538,2231472,11619972
"Belgium","EUROPE",2040,2634238,3550504,2980954,3128184,12293880
"Belgium","EUROPE",2060,2710632,3585470,2867944,3433395,12597441
"Belgium","EUROPE",2080,2688210,3593950,2924901,3599175,12806236
"Belgium","EUROPE",2100,2666301,3530787,2921681,3903264,13022033
"Belarus","EUROPE",2020,2084488,3246376,2613514,1471053,9415431
"Belarus","EUROPE",2040,1863182,2535242,2533475,1905438,8837337
"Belarus","EUROPE",2060,1871021,2414126,1854629,2156773,8296549
"Belarus","EUROPE",2080,1707681,2327738,1861097,1923692,7820208
"Belarus","EUROPE",2100,1629580,2149597,1817777,2008186,7605140
"Austria","EUROPE",2020,1665553,2787887,2584398,1744372,8782210
"Austria","EUROPE",2040,1654560,2368915,2348288,2590347,8962110
"Austria","EUROPE",2060,1620406,2335110,1969792,2779885,8705193
"Austria","EUROPE",2080,1573085,2215149,1973628,2622986,8384848
"Austria","EUROPE",2100,1549775,2133771,1832529,2673283,8189358
"Vanuatu","OCEANIA",2020,130686,107381,41860,14007,293934
"Vanuatu","OCEANIA",2040,155456,151394,76803,31428,415081
"Vanuatu","OCEANIA",2060,169424,184740,112495,62956,529615
"Vanuatu","OCEANIA",2080,169435,204995,141145,103415,618990
"Vanuatu","OCEANIA",2100,160799,208357,160003,145517,674676
"Tonga","OCEANIA",2020,50631,36834,17026,6546,111037
"Tonga","OCEANIA",2040,51711,48535,19878,11782,131906
"Tonga","OCEANIA",2060,48466,50410,31332,16024,146232
"Tonga","OCEANIA",2080,45355,51050,33089,27034,156528
"Tonga","OCEANIA",2100,38938,49217,36180,33877,158212
"Solomon Islands","OCEANIA",2020,313640,226248,83999,23410,647297
"Solomon Islands","OCEANIA",2040,362235,341149,143853,57836,905073
"Solomon Islands","OCEANIA",2060,387284,410602,239648,112301,1149835
"Solomon Islands","OCEANIA",2080,382011,455187,299277,209294,1345769
"Solomon Islands","OCEANIA",2100,353902,458610,345782,299583,1457877
"Samoa","OCEANIA",2020,92665,62546,32690,12216,200117
"Samoa","OCEANIA",2040,90442,81542,33323,24619,229926
"Samoa","OCEANIA",2060,83998,84208,53227,31452,252885
"Samoa","OCEANIA",2080,75750,84589,55883,52787,269009
"Samoa","OCEANIA",2100,62258,78675,60987,66160,268080
"Papua New Guinea","OCEANIA",2020,3956004,3211432,1233482,354757,8755675
"Papua New Guinea","OCEANIA",2040,4744975,4636293,2114280,728754,12224302
"Papua New Guinea","OCEANIA",2060,5184733,5663799,3217914,1300445,15366891
"Papua New Guinea","OCEANIA",2080,5255498,6299845,4039094,2091195,17685632
"Papua New Guinea","OCEANIA",2100,5003469,6467079,4624093,2864802,18959443
"New Zealand","OCEANIA",2020,1251773,1568829,1224082,789736,4834420
"New Zealand","OCEANIA",2040,1274086,1687367,1269366,1271353,5502172
"New Zealand","OCEANIA",2060,1264156,1715712,1386281,1497370,5863519
"New Zealand","OCEANIA",2080,1233144,1680279,1417947,1756793,6088163
"New Zealand","OCEANIA",2100,1195470,1623593,1381856,1929911,6130830
"New Caledonia","OCEANIA",2020,83877,102532,70641,29863,286913
"New Caledonia","OCEANIA",2040,89259,119480,82403,60522,351664
"New Caledonia","OCEANIA",2060,90369,125911,98346,83987,398613
"New Caledonia","OCEANIA",2080,90062,124752,104263,108671,427748
"New Caledonia","OCEANIA",2100,88362,121824,102530,125814,438530
"Micronesia (Fed. States of)","OCEANIA",2020,46685,42197,12965,5927,107774
"Micronesia (Fed. States of)","OCEANIA",2040,46021,47528,23731,7214,124494
"Micronesia (Fed. States of)","OCEANIA",2060,38025,46713,30322,15534,130594
"Micronesia (Fed. States of)","OCEANIA",2080,30891,39679,31865,20695,123130
"Micronesia (Fed. States of)","OCEANIA",2100,25491,33714,27248,24176,110629
"Kiribati","OCEANIA",2020,54027,44569,18698,5145,122439
"Kiribati","OCEANIA",2040,61531,58279,28453,11032,159295
"Kiribati","OCEANIA",2060,68715,69164,38898,18512,195289
"Kiribati","OCEANIA",2080,68544,78596,49071,27486,223697
"Kiribati","OCEANIA",2100,66206,81159,58000,37760,243125
"Guam","OCEANIA",2020,53990,58538,38369,17830,168727
"Guam","OCEANIA",2040,50786,63324,40879,34167,189156
"Guam","OCEANIA",2060,43791,59150,47189,43235,193365
"Guam","OCEANIA",2080,38021,51832,45015,54191,189059
"Guam","OCEANIA",2100,33264,45619,39804,58023,176710
"French Polynesia","OCEANIA",2020,87595,108642,69003,25504,290744
"French Polynesia","OCEANIA",2040,77206,106270,79671,56689,319836
"French Polynesia","OCEANIA",2060,68372,96347,82319,78402,325440
"French Polynesia","OCEANIA",2080,60591,85213,76201,91307,313312
"French Polynesia","OCEANIA",2100,54317,75474,68063,94132,291986
"Fiji","OCEANIA",2020,337013,341320,183150,63432,924915
"Fiji","OCEANIA",2040,303394,355350,223896,112161,994801
"Fiji","OCEANIA",2060,259264,329466,238520,158014,985264
"Fiji","OCEANIA",2080,215154,286964,230074,195500,927692
"Fiji","OCEANIA",2100,179801,242212,208435,216006,846454
"Australia","OCEANIA",2020,6408435,8657661,6199895,4132186,25398177
"Australia","OCEANIA",2040,7194571,9671173,7378276,6520621,30764641
"Australia","OCEANIA",2060,8021483,10807307,8025484,8550183,35404457
"Australia","OCEANIA",2080,8358500,11390871,9043337,10273776,39066484
"Australia","OCEANIA",2100,8565491,11544388,9418283,12306424,41834586
